cbsa_fips,name,bldgs,strct,sites,objct,dists,hist_reg
10180,"Abilene, TX",1,0,0,0,0,1
10420,"Akron, OH",9,12,1,1,7,30
10500,"Albany, GA",2,0,0,0,1,3
10580,"Albany-Schenectady-Troy, NY",59,11,6,1,11,88
10740,"Albuquerque, NM",0,3,3,1,2,9
10780,"Alexandria, LA",3,1,6,0,0,10
10900,"Allentown-Bethlehem-Easton, PA-NJ",10,19,1,2,3,35
11020,"Altoona, PA",2,3,1,0,1,7
11100,"Amarillo, TX",1,0,0,0,1,2
11180,"Ames, IA",0,6,0,0,1,7
11260,"Anchorage, AK",2,2,0,1,1,6
11460,"Ann Arbor, MI",1,2,0,0,3,6
11500,"Anniston-Oxford-Jacksonville, AL",3,2,1,1,0,7
11540,"Appleton, WI",0,1,1,0,5,7
11700,"Asheville, NC",10,0,0,0,7,17
12020,"Athens-Clarke County, GA",4,1,0,0,8,13
12060,"Atlanta-Sandy Springs-Roswell, GA",40,9,2,2,21,74
12100,"Atlantic City-Hammonton, NJ",1,2,0,2,0,5
12220,"Auburn-Opelika, AL",1,0,2,0,1,4
12260,"Augusta-Richmond County, GA-SC",15,0,1,0,1,17
12420,"Austin-Round Rock, TX",3,10,2,0,3,18
12540,"Bakersfield, CA",1,1,1,0,0,3
12580,"Baltimore-Columbia-Towson, MD",108,29,4,1,10,152
12620,"Bangor, ME",1,2,1,1,3,8
12700,"Barnstable Town, MA",9,11,4,3,2,29
12940,"Baton Rouge, LA",27,3,3,0,1,34
12980,"Battle Creek, MI",2,3,1,0,1,7
13020,"Bay City, MI",0,0,0,0,0,0
13140,"Beaumont-Port Arthur, TX",1,4,0,0,0,5
13380,"Bellingham, WA",0,3,1,3,1,8
13460,"Bend-Redmond, OR",1,1,0,0,1,3
13740,"Billings, MT",1,2,2,0,3,8
13780,"Binghamton, NY",14,6,1,6,0,27
13820,"Birmingham-Hoover, AL",4,5,1,1,6,17
13900,"Bismarck, ND",0,0,1,0,1,2
13980,"Blacksburg-Christiansburg-Radford, VA",11,2,0,0,2,15
14010,"Bloomington, IL",0,3,0,0,0,3
14020,"Bloomington, IN",3,3,0,0,1,7
14260,"Boise City, ID",3,2,4,0,1,10
14460,"Boston-Cambridge-Newton, MA-NH",64,56,40,9,86,255
14500,"Boulder, CO",2,2,1,0,3,8
14540,"Bowling Green, KY",8,8,2,3,9,30
14740,"Bremerton-Silverdale, WA",0,3,0,0,2,5
14860,"Bridgeport-Stamford-Norwalk, CT",11,16,1,1,10,39
15180,"Brownsville-Harlingen, TX",0,1,0,0,0,1
15260,"Brunswick, GA",2,0,2,0,2,6
15380,"Buffalo-Cheektowaga-Niagara Falls, NY",13,8,1,0,2,24
15500,"Burlington, NC",5,1,0,0,1,7
15540,"Burlington-South Burlington, VT",5,18,3,0,3,29
15940,"Canton-Massillon, OH",4,0,2,0,4,10
15980,"Cape Coral-Fort Myers, FL",0,0,1,0,1,2
16180,"Carson City, NV",2,5,0,0,0,7
16220,"Casper, WY",3,2,3,0,0,8
16300,"Cedar Rapids, IA",6,15,1,1,1,24
16580,"Champaign-Urbana, IL",1,2,1,1,1,6
16620,"Charleston, WV",0,1,0,0,1,2
16700,"Charleston-North Charleston, SC",22,21,6,0,9,58
16740,"Charlotte-Concord-Gastonia, NC-SC",43,2,4,1,23,73
16820,"Charlottesville, VA",64,2,0,5,0,71
16860,"Chattanooga, TN-GA",3,9,2,0,11,25
16940,"Cheyenne, WY",2,0,0,0,0,2
16980,"Chicago-Naperville-Elgin, IL-IN-WI",29,14,9,2,10,64
17020,"Chico, CA",0,1,0,0,0,1
17140,"Cincinnati, OH-KY-IN",41,24,4,4,20,93
17300,"Clarksville, TN-KY",3,0,3,3,2,11
17420,"Cleveland, TN",1,1,0,1,2,5
17460,"Cleveland-Elyria, OH",11,19,2,1,12,45
17660,"Coeur d'Alene, ID",1,2,1,0,1,5
17780,"College Station-Bryan, TX",0,0,0,0,1,1
17820,"Colorado Springs, CO",3,6,0,0,4,13
17860,"Columbia, MO",2,0,0,0,2,4
17900,"Columbia, SC",17,3,3,0,6,29
17980,"Columbus, GA-AL",7,2,0,0,2,11
18020,"Columbus, IN",2,2,0,0,0,4
18140,"Columbus, OH",18,19,3,0,6,46
18580,"Corpus Christi, TX",1,0,0,0,0,1
18700,"Corvallis, OR",0,2,0,0,0,2
18880,"Crestview-Fort Walton Beach-Destin, FL",0,0,0,0,1,1
19060,"Cumberland, MD-WV",3,2,0,0,0,5
19100,"Dallas-Fort Worth-Arlington, TX",5,7,1,0,3,16
19140,"Dalton, GA",2,2,0,0,0,4
19180,"Danville, IL",0,1,0,0,0,1
19340,"Davenport-Moline-Rock Island, IA-IL",4,6,0,0,3,13
19380,"Dayton, OH",9,6,5,0,2,22
19460,"Decatur, AL",6,0,0,0,1,7
19500,"Decatur, IL",0,0,0,0,0,0
19660,"Deltona-Daytona Beach-Ormond Beach, FL",0,2,3,0,9,14
19740,"Denver-Aurora-Lakewood, CO",14,20,5,0,11,50
19780,"Des Moines-West Des Moines, IA",6,16,1,0,4,27
19820,"Detroit-Warren-Dearborn, MI",12,30,0,2,24,68
20020,"Dothan, AL",0,0,0,0,0,0
20100,"Dover, DE",20,2,0,0,2,24
20220,"Dubuque, IA",1,4,1,1,0,7
20260,"Duluth, MN-WI",5,12,3,0,5,25
20500,"Durham-Chapel Hill, NC",31,1,0,0,7,39
20740,"Eau Claire, WI",0,5,0,0,0,5
20940,"El Centro, CA",0,0,1,0,0,1
21060,"Elizabethtown-Fort Knox, KY",4,0,0,1,5,10
21140,"Elkhart-Goshen, IN",1,1,0,0,2,4
21300,"Elmira, NY",2,0,1,0,2,5
21340,"El Paso, TX",2,0,0,0,1,3
21500,"Erie, PA",1,4,0,0,1,6
21660,"Eugene, OR",2,23,0,1,2,28
21780,"Evansville, IN-KY",3,1,0,0,1,5
21820,"Fairbanks, AK",2,4,1,0,2,9
22020,"Fargo, ND-MN",0,0,0,0,0,0
22140,"Farmington, NM",0,1,0,0,1,2
22180,"Fayetteville, NC",4,0,0,0,2,6
22220,"Fayetteville-Springdale-Rogers, AR-MO",10,17,6,2,2,37
22380,"Flagstaff, AZ",4,26,12,1,2,45
22420,"Flint, MI",1,2,0,0,1,4
22500,"Florence, SC",6,0,2,0,2,10
22520,"Florence-Muscle Shoals, AL",8,2,2,0,7,19
22540,"Fond du Lac, WI",0,0,1,2,1,4
22660,"Fort Collins, CO",3,3,0,0,4,10
22900,"Fort Smith, AR-OK",3,11,4,3,0,21
23060,"Fort Wayne, IN",2,2,0,0,2,6
23420,"Fresno, CA",2,2,2,0,1,7
23460,"Gadsden, AL",0,1,0,0,1,2
23540,"Gainesville, FL",0,0,0,0,0,0
23580,"Gainesville, GA",0,0,0,0,1,1
24020,"Glens Falls, NY",4,4,1,0,2,11
24140,"Goldsboro, NC",1,0,0,0,0,1
24220,"Grand Forks, ND-MN",1,4,0,0,0,5
24300,"Grand Junction, CO",0,2,0,1,3,6
24340,"Grand Rapids-Wyoming, MI",1,10,0,1,1,13
24500,"Great Falls, MT",0,2,0,0,2,4
24540,"Greeley, CO",1,1,1,0,2,5
24580,"Green Bay, WI",2,3,0,0,5,10
24660,"Greensboro-High Point, NC",17,2,1,0,3,23
24780,"Greenville, NC",3,0,0,0,1,4
24860,"Greenville-Anderson-Mauldin, SC",11,2,3,0,3,19
25060,"Gulfport-Biloxi-Pascagoula, MS",1,2,1,0,7,11
25180,"Hagerstown-Martinsburg, MD-WV",33,6,2,0,3,44
25260,"Hanford-Corcoran, CA",0,0,0,0,0,0
25420,"Harrisburg-Carlisle, PA",10,24,1,0,2,37
25500,"Harrisonburg, VA",7,1,0,0,0,8
25540,"Hartford-West Hartford-East Hartford, CT",35,19,3,1,11,69
25620,"Hattiesburg, MS",0,1,0,0,0,1
25860,"Hickory-Lenoir-Morganton, NC",8,3,2,0,5,18
25980,"Hinesville, GA",1,1,0,0,0,2
26300,"Hot Springs, AR",0,4,2,1,10,17
26380,"Houma-Thibodaux, LA",2,0,0,0,0,2
26420,"Houston-The Woodlands-Sugar Land, TX",2,17,1,2,1,23
26580,"Huntington-Ashland, WV-KY-OH",5,9,2,1,6,23
26620,"Huntsville, AL",6,5,2,0,2,15
26820,"Idaho Falls, ID",3,2,0,0,0,5
26900,"Indianapolis-Carmel-Anderson, IN",11,11,4,0,9,35
26980,"Iowa City, IA",2,2,1,0,1,6
27060,"Ithaca, NY",1,1,0,0,0,2
27100,"Jackson, MI",2,3,0,0,0,5
27140,"Jackson, MS",9,9,3,1,5,27
27180,"Jackson, TN",1,0,0,0,0,1
27260,"Jacksonville, FL",4,5,4,0,2,15
27340,"Jacksonville, NC",0,0,0,0,2,2
27500,"Janesville-Beloit, WI",0,2,2,0,5,9
27620,"Jefferson City, MO",3,0,1,0,3,7
27740,"Johnson City, TN",1,0,1,0,1,3
27780,"Johnstown, PA",0,7,0,0,2,9
27860,"Jonesboro, AR",1,5,0,0,1,7
27900,"Joplin, MO",1,0,0,0,1,2
28020,"Kalamazoo-Portage, MI",1,1,0,0,4,6
28100,"Kankakee, IL",0,0,0,0,0,0
28140,"Kansas City, MO-KS",17,11,10,0,13,51
28420,"Kennewick-Richland, WA",0,1,0,0,0,1
28660,"Killeen-Temple, TX",1,4,0,0,0,5
28700,"Kingsport-Bristol-Bristol, TN-VA",7,1,1,1,1,11
28740,"Kingston, NY",41,15,2,0,4,62
28940,"Knoxville, TN",5,6,8,0,10,29
29020,"Kokomo, IN",1,0,0,0,0,1
29100,"La Crosse-Onalaska, WI-MN",1,8,0,0,0,9
29180,"Lafayette, LA",2,1,0,0,3,6
29200,"Lafayette-West Lafayette, IN",1,5,1,0,2,9
29340,"Lake Charles, LA",0,1,0,0,0,1
29460,"Lakeland-Winter Haven, FL",0,0,1,0,1,2
29540,"Lancaster, PA",11,53,4,0,10,78
29620,"Lansing-East Lansing, MI",1,5,0,0,1,7
29700,"Laredo, TX",0,0,0,0,0,0
29740,"Las Cruces, NM",0,1,2,1,1,5
29820,"Las Vegas-Henderson-Paradise, NV",4,1,2,0,0,7
29940,"Lawrence, KS",0,1,1,0,1,3
30020,"Lawton, OK",1,1,2,0,0,4
30140,"Lebanon, PA",2,2,0,0,0,4
30300,"Lewiston, ID-WA",0,4,0,0,1,5
30340,"Lewiston-Auburn, ME",0,0,0,0,1,1
30460,"Lexington-Fayette, KY",79,2,4,9,8,102
30620,"Lima, OH",1,1,0,0,0,2
30700,"Lincoln, NE",3,2,0,0,1,6
30780,"Little Rock-North Little Rock-Conway, AR",4,14,5,9,5,37
30860,"Logan, UT-ID",2,2,1,0,0,5
30980,"Longview, TX",0,0,0,0,0,0
31020,"Longview, WA",1,3,0,0,0,4
31080,"Los Angeles-Long Beach-Anaheim, CA",12,17,4,2,43,78
31140,"Louisville/Jefferson County, KY-IN",44,4,3,7,17,75
31180,"Lubbock, TX",0,0,0,0,1,1
31340,"Lynchburg, VA",28,1,1,0,3,33
31420,"Macon-Bibb County, GA",9,2,0,0,2,13
31460,"Madera, CA",0,0,0,0,0,0
31540,"Madison, WI",7,3,4,0,9,23
31700,"Manchester-Nashua, NH",5,4,0,0,4,13
31900,"Mansfield, OH",1,2,0,0,0,3
32580,"McAllen-Edinburg-Mission, TX",5,0,0,0,0,5
32780,"Medford, OR",3,6,4,0,2,15
32820,"Memphis, TN-MS-AR",11,0,4,1,8,24
32900,"Merced, CA",1,0,0,0,0,1
33100,"Miami-Fort Lauderdale-West Palm Beach, FL",6,11,2,1,5,25
33140,"Michigan City-La Porte, IN",0,0,0,0,0,0
33260,"Midland, TX",0,0,0,0,0,0
33340,"Milwaukee-Waukesha-West Allis, WI",10,7,2,0,16,35
33460,"Minneapolis-St. Paul-Bloomington, MN-WI",6,33,4,0,7,50
33540,"Missoula, MT",0,0,0,0,1,1
33660,"Mobile, AL",4,2,1,1,2,10
33700,"Modesto, CA",0,1,0,0,0,1
33740,"Monroe, LA",1,0,0,0,0,1
33780,"Monroe, MI",0,1,0,1,1,3
33860,"Montgomery, AL",1,1,0,0,2,4
34060,"Morgantown, WV",0,2,2,0,3,7
34100,"Morristown, TN",1,0,0,0,0,1
34580,"Mount Vernon-Anacortes, WA",0,5,1,0,1,7
34620,"Muncie, IN",2,0,0,0,1,3
34740,"Muskegon, MI",0,1,0,0,0,1
34820,"Myrtle Beach-Conway-North Myrtle Beach, SC-NC",4,2,1,0,1,8
34900,"Napa, CA",0,9,0,0,2,11
34940,"Naples-Immokalee-Marco Island, FL",1,0,1,0,0,2
34980,"Nashville-Davidson--Murfreesboro--Franklin, TN",56,6,11,0,17,90
35300,"New Haven-Milford, CT",11,8,2,0,2,23
35380,"New Orleans-Metairie, LA",8,12,5,2,1,28
35620,"New York-Newark-Jersey City, NY-NJ-PA",212,140,28,15,92,487
35660,"Niles-Benton Harbor, MI",0,3,0,0,3,6
35840,"North Port-Sarasota-Bradenton, FL",5,1,3,0,5,14
35980,"Norwich-New London, CT",22,14,2,0,5,43
36100,"Ocala, FL",1,0,0,0,1,2
36140,"Ocean City, NJ",0,3,0,0,0,3
36220,"Odessa, TX",0,0,0,0,0,0
36260,"Ogden-Clearfield, UT",3,1,0,0,3,7
36420,"Oklahoma City, OK",3,7,4,0,6,20
36500,"Olympia-Tumwater, WA",1,4,5,0,0,10
36540,"Omaha-Council Bluffs, NE-IA",5,10,4,1,5,25
36740,"Orlando-Kissimmee-Sanford, FL",1,0,2,0,3,6
36780,"Oshkosh-Neenah, WI",1,3,0,0,0,4
36980,"Owensboro, KY",3,0,0,2,1,6
37100,"Oxnard-Thousand Oaks-Ventura, CA",0,1,0,0,2,3
37340,"Palm Bay-Melbourne-Titusville, FL",1,1,0,2,0,4
37460,"Panama City, FL",1,0,0,0,0,1
37620,"Parkersburg-Vienna, WV",1,1,0,1,0,3
37860,"Pensacola-Ferry Pass-Brent, FL",0,0,3,0,0,3
37900,"Peoria, IL",2,4,0,2,1,9
37980,"Philadelphia-Camden-Wilmington, PA-NJ-DE-MD",172,90,13,0,30,305
38060,"Phoenix-Mesa-Scottsdale, AZ",7,26,2,1,8,44
38220,"Pine Bluff, AR",3,4,4,4,1,16
38300,"Pittsburgh, PA",20,64,8,0,7,99
38340,"Pittsfield, MA",24,4,1,0,3,32
38540,"Pocatello, ID",0,0,1,0,1,2
38860,"Portland-South Portland, ME",16,11,3,2,19,51
38900,"Portland-Vancouver-Hillsboro, OR-WA",8,8,9,0,3,28
38940,"Port St. Lucie, FL",1,2,2,0,0,5
39140,"Prescott, AZ",2,12,1,0,2,17
39300,"Providence-Warwick, RI-MA",96,32,13,8,21,170
39340,"Provo-Orem, UT",0,6,14,0,3,23
39380,"Pueblo, CO",1,5,1,0,0,7
39460,"Punta Gorda, FL",0,0,0,0,0,0
39540,"Racine, WI",3,0,0,0,0,3
39580,"Raleigh, NC",21,1,2,0,7,31
39660,"Rapid City, SD",1,7,2,1,7,18
39740,"Reading, PA",31,14,1,0,3,49
39820,"Redding, CA",0,0,1,0,3,4
39900,"Reno, NV",1,3,0,1,1,6
40060,"Richmond, VA",119,6,6,3,10,144
40140,"Riverside-San Bernardino-Ontario, CA",2,4,1,1,5,13
40220,"Roanoke, VA",15,6,0,1,5,27
40340,"Rochester, MN",3,10,0,0,0,13
40380,"Rochester, NY",57,8,2,0,14,81
40420,"Rockford, IL",1,1,1,0,0,3
40580,"Rocky Mount, NC",11,1,1,0,0,13
40660,"Rome, GA",9,1,0,0,1,11
40900,"Sacramento--Roseville--Arden-Arcade, CA",7,5,5,0,11,28
40980,"Saginaw, MI",1,6,0,0,0,7
41060,"St. Cloud, MN",1,0,0,0,1,2
41100,"St. George, UT",0,25,2,1,3,31
41140,"St. Joseph, MO-KS",0,1,0,1,4,6
41180,"St. Louis, MO-IL",15,13,2,0,37,67
41420,"Salem, OR",2,2,1,0,2,7
41500,"Salinas, CA",1,1,1,0,2,5
41540,"Salisbury, MD-DE",41,11,3,1,5,61
41620,"Salt Lake City, UT",4,2,3,2,3,14
41660,"San Angelo, TX",0,1,0,0,0,1
41700,"San Antonio-New Braunfels, TX",9,9,2,2,4,26
41740,"San Diego-Carlsbad, CA",9,6,2,0,2,19
41860,"San Francisco-Oakland-Hayward, CA",9,18,8,2,19,56
41940,"San Jose-Sunnyvale-Santa Clara, CA",2,3,0,0,6,11
42020,"San Luis Obispo-Paso Robles-Arroyo Grande, CA",1,0,1,0,1,3
42100,"Santa Cruz-Watsonville, CA",1,2,1,0,4,8
42140,"Santa Fe, NM",2,4,1,1,3,11
42200,"Santa Maria-Santa Barbara, CA",1,1,0,0,3,5
42220,"Santa Rosa, CA",4,1,1,0,3,9
42340,"Savannah, GA",2,0,0,0,6,8
42540,"Scranton--Wilkes-Barre--Hazleton, PA",3,6,1,1,0,11
42660,"Seattle-Tacoma-Bellevue, WA",14,57,4,2,6,83
42680,"Sebastian-Vero Beach, FL",1,0,0,0,2,3
43100,"Sheboygan, WI",3,0,1,0,1,5
43300,"Sherman-Denison, TX",0,0,0,0,0,0
43340,"Shreveport-Bossier City, LA",1,2,1,1,4,9
43580,"Sioux City, IA-NE-SD",1,4,0,0,2,7
43620,"Sioux Falls, SD",4,30,1,0,1,36
43780,"South Bend-Mishawaka, IN-MI",5,3,0,0,2,10
43900,"Spartanburg, SC",9,1,1,1,1,13
44060,"Spokane-Spokane Valley, WA",0,11,1,1,1,14
44100,"Springfield, IL",3,5,0,0,1,9
44140,"Springfield, MA",13,1,4,0,11,29
44180,"Springfield, MO",1,1,1,0,4,7
44220,"Springfield, OH",3,0,0,0,1,4
44300,"State College, PA",6,0,0,0,1,7
44700,"Stockton-Lodi, CA",1,2,0,0,0,3
44940,"Sumter, SC",7,0,1,0,0,8
45060,"Syracuse, NY",18,5,1,0,10,34
45220,"Tallahassee, FL",5,1,2,0,4,12
45300,"Tampa-St. Petersburg-Clearwater, FL",3,7,0,0,2,12
45460,"Terre Haute, IN",5,8,1,0,0,14
45500,"Texarkana, TX-AR",0,0,1,0,1,2
45780,"Toledo, OH",1,2,2,0,7,12
45820,"Topeka, KS",3,7,3,0,2,15
45940,"Trenton, NJ",9,2,0,2,2,15
46060,"Tucson, AZ",7,5,17,1,1,31
46140,"Tulsa, OK",2,6,8,0,2,18
46220,"Tuscaloosa, AL",5,1,0,0,5,11
46340,"Tyler, TX",0,1,0,0,0,1
46520,"Urban Honolulu, HI",1,15,7,0,0,23
46540,"Utica-Rome, NY",6,5,1,0,2,14
46660,"Valdosta, GA",3,0,0,0,2,5
46700,"Vallejo-Fairfield, CA",1,2,1,0,0,4
47020,"Victoria, TX",1,1,1,0,0,3
47220,"Vineland-Bridgeton, NJ",0,2,0,0,0,2
47260,"Virginia Beach-Norfolk-Newport News, VA-NC",40,10,1,2,6,59
47300,"Visalia-Porterville, CA",0,2,0,2,4,8
47380,"Waco, TX",0,2,0,0,0,2
47580,"Warner Robins, GA",2,0,0,0,0,2
47900,"Washington-Arlington-Alexandria, DC-VA-MD-WV",222,34,7,38,18,319
47940,"Waterloo-Cedar Falls, IA",0,2,0,0,1,3
48140,"Wausau, WI",0,0,0,0,0,0
48260,"Weirton-Steubenville, WV-OH",1,3,0,1,0,5
48300,"Wenatchee, WA",0,10,2,0,2,14
48540,"Wheeling, WV-OH",0,3,0,0,3,6
48620,"Wichita, KS",1,6,0,1,3,11
48660,"Wichita Falls, TX",0,2,0,0,0,2
48700,"Williamsport, PA",1,8,0,0,0,9
48900,"Wilmington, NC",3,2,2,0,1,8
49020,"Winchester, VA-WV",11,0,1,0,2,14
49180,"Winston-Salem, NC",24,1,12,0,2,39
49340,"Worcester, MA-CT",38,10,3,0,20,71
49420,"Yakima, WA",2,5,0,0,0,7
49620,"York-Hanover, PA",4,17,0,0,2,23
49660,"Youngstown-Warren-Boardman, OH-PA",4,6,0,0,6,16
49700,"Yuba City, CA",0,1,0,0,1,2
49740,"Yuma, AZ",0,6,0,2,0,8
