cbsa_fips,name,bldgs,strct,sites,objct,dists,hist_reg
10180,"Abilene, TX",1,0,0,0,0,1
10420,"Akron, OH",11,12,1,1,8,33
10500,"Albany, GA",2,0,0,0,1,3
10580,"Albany-Schenectady-Troy, NY",69,12,7,3,14,105
10740,"Albuquerque, NM",0,4,3,2,2,11
10780,"Alexandria, LA",3,1,6,0,0,10
10900,"Allentown-Bethlehem-Easton, PA-NJ",11,19,1,2,4,37
11020,"Altoona, PA",2,3,1,0,1,7
11100,"Amarillo, TX",2,2,0,0,2,6
11180,"Ames, IA",0,6,0,0,1,7
11260,"Anchorage, AK",2,2,0,1,2,7
11460,"Ann Arbor, MI",1,3,0,0,5,9
11500,"Anniston-Oxford-Jacksonville, AL",3,2,1,1,0,7
11540,"Appleton, WI",0,1,1,0,5,7
11700,"Asheville, NC",11,0,0,0,14,25
12020,"Athens-Clarke County, GA",4,1,1,0,9,15
12060,"Atlanta-Sandy Springs-Roswell, GA",43,10,3,2,25,83
12100,"Atlantic City-Hammonton, NJ",1,2,0,2,0,5
12220,"Auburn-Opelika, AL",1,0,2,0,1,4
12260,"Augusta-Richmond County, GA-SC",16,0,1,0,1,18
12420,"Austin-Round Rock, TX",3,10,2,0,5,20
12540,"Bakersfield, CA",1,1,1,0,0,3
12580,"Baltimore-Columbia-Towson, MD",116,30,4,1,12,163
12620,"Bangor, ME",1,2,1,1,3,8
12700,"Barnstable Town, MA",10,11,5,3,2,31
12940,"Baton Rouge, LA",27,3,3,0,2,35
12980,"Battle Creek, MI",2,3,1,0,1,7
13020,"Bay City, MI",0,0,0,0,0,0
13140,"Beaumont-Port Arthur, TX",1,8,0,0,1,10
13380,"Bellingham, WA",0,3,1,3,1,8
13460,"Bend-Redmond, OR",1,1,0,0,1,3
13740,"Billings, MT",1,5,3,0,4,13
13780,"Binghamton, NY",15,7,2,6,3,33
13820,"Birmingham-Hoover, AL",4,5,1,1,7,18
13900,"Bismarck, ND",1,0,1,0,2,4
13980,"Blacksburg-Christiansburg-Radford, VA",16,3,2,0,4,25
14010,"Bloomington, IL",0,3,0,0,0,3
14020,"Bloomington, IN",4,3,0,0,1,8
14260,"Boise City, ID",3,3,4,0,1,11
14460,"Boston-Cambridge-Newton, MA-NH",72,58,48,9,89,276
14500,"Boulder, CO",2,2,1,0,3,8
14540,"Bowling Green, KY",9,8,2,3,10,32
14740,"Bremerton-Silverdale, WA",0,3,0,0,2,5
14860,"Bridgeport-Stamford-Norwalk, CT",11,17,1,1,13,43
15180,"Brownsville-Harlingen, TX",0,1,1,0,0,2
15260,"Brunswick, GA",2,0,2,0,2,6
15380,"Buffalo-Cheektowaga-Niagara Falls, NY",15,16,3,0,8,42
15500,"Burlington, NC",7,1,0,0,3,11
15540,"Burlington-South Burlington, VT",5,20,3,0,5,33
15940,"Canton-Massillon, OH",4,1,2,0,4,11
15980,"Cape Coral-Fort Myers, FL",1,0,1,0,3,5
16180,"Carson City, NV",2,5,0,0,0,7
16220,"Casper, WY",3,2,3,0,0,8
16300,"Cedar Rapids, IA",9,15,1,1,3,29
16580,"Champaign-Urbana, IL",2,2,1,1,1,7
16620,"Charleston, WV",0,1,0,0,1,2
16700,"Charleston-North Charleston, SC",22,21,6,0,9,58
16740,"Charlotte-Concord-Gastonia, NC-SC",51,2,5,1,26,85
16820,"Charlottesville, VA",75,2,1,6,2,86
16860,"Chattanooga, TN-GA",3,12,3,0,11,29
16940,"Cheyenne, WY",3,0,0,0,0,3
16980,"Chicago-Naperville-Elgin, IL-IN-WI",35,15,9,2,20,81
17020,"Chico, CA",0,1,0,0,0,1
17140,"Cincinnati, OH-KY-IN",47,24,4,4,26,105
17300,"Clarksville, TN-KY",3,2,3,3,2,13
17420,"Cleveland, TN",1,3,1,1,2,8
17460,"Cleveland-Elyria, OH",13,19,2,1,20,55
17660,"Coeur d'Alene, ID",1,2,1,0,1,5
17780,"College Station-Bryan, TX",0,0,0,0,1,1
17820,"Colorado Springs, CO",3,7,0,0,6,16
17860,"Columbia, MO",2,0,0,0,3,5
17900,"Columbia, SC",22,3,3,0,6,34
17980,"Columbus, GA-AL",8,2,0,0,3,13
18020,"Columbus, IN",2,2,0,0,0,4
18140,"Columbus, OH",21,19,3,0,9,52
18580,"Corpus Christi, TX",1,0,0,0,0,1
18700,"Corvallis, OR",0,3,0,0,0,3
18880,"Crestview-Fort Walton Beach-Destin, FL",0,0,0,0,1,1
19060,"Cumberland, MD-WV",3,2,0,0,0,5
19100,"Dallas-Fort Worth-Arlington, TX",5,7,2,0,9,23
19140,"Dalton, GA",2,2,0,0,0,4
19180,"Danville, IL",0,1,0,0,0,1
19340,"Davenport-Moline-Rock Island, IA-IL",4,6,0,0,5,15
19380,"Dayton, OH",9,6,5,0,3,23
19460,"Decatur, AL",6,0,0,0,1,7
19500,"Decatur, IL",0,0,0,0,0,0
19660,"Deltona-Daytona Beach-Ormond Beach, FL",0,2,5,0,9,16
19740,"Denver-Aurora-Lakewood, CO",16,22,5,0,14,57
19780,"Des Moines-West Des Moines, IA",6,16,1,0,5,28
19820,"Detroit-Warren-Dearborn, MI",13,33,0,2,29,77
20020,"Dothan, AL",0,0,0,0,0,0
20100,"Dover, DE",20,2,0,0,2,24
20220,"Dubuque, IA",1,5,1,1,4,12
20260,"Duluth, MN-WI",7,12,3,1,6,29
20500,"Durham-Chapel Hill, NC",36,1,0,0,9,46
20740,"Eau Claire, WI",0,5,0,0,2,7
20940,"El Centro, CA",0,0,1,0,0,1
21060,"Elizabethtown-Fort Knox, KY",4,0,0,1,6,11
21140,"Elkhart-Goshen, IN",1,2,1,0,2,6
21300,"Elmira, NY",3,0,3,0,2,8
21340,"El Paso, TX",2,0,0,0,1,3
21500,"Erie, PA",1,4,0,0,1,6
21660,"Eugene, OR",2,23,0,2,2,29
21780,"Evansville, IN-KY",3,2,0,0,1,6
21820,"Fairbanks, AK",2,4,1,0,2,9
22020,"Fargo, ND-MN",0,0,0,0,1,1
22140,"Farmington, NM",0,1,0,0,1,2
22180,"Fayetteville, NC",4,0,0,0,2,6
22220,"Fayetteville-Springdale-Rogers, AR-MO",11,27,10,3,9,60
22380,"Flagstaff, AZ",7,26,13,1,2,49
22420,"Flint, MI",1,2,0,0,1,4
22500,"Florence, SC",6,0,2,0,2,10
22520,"Florence-Muscle Shoals, AL",8,2,2,0,7,19
22540,"Fond du Lac, WI",0,0,2,2,1,5
22660,"Fort Collins, CO",3,5,0,0,6,14
22900,"Fort Smith, AR-OK",3,15,4,3,1,26
23060,"Fort Wayne, IN",2,2,0,0,2,6
23420,"Fresno, CA",2,2,2,0,1,7
23460,"Gadsden, AL",0,1,0,0,1,2
23540,"Gainesville, FL",0,0,0,0,0,0
23580,"Gainesville, GA",0,0,0,0,1,1
24020,"Glens Falls, NY",7,5,4,0,2,18
24140,"Goldsboro, NC",1,0,0,0,0,1
24220,"Grand Forks, ND-MN",2,4,0,0,0,6
24300,"Grand Junction, CO",0,2,0,1,3,6
24340,"Grand Rapids-Wyoming, MI",1,10,0,1,1,13
24500,"Great Falls, MT",0,4,0,0,3,7
24540,"Greeley, CO",1,1,1,0,2,5
24580,"Green Bay, WI",2,5,0,0,7,14
24660,"Greensboro-High Point, NC",17,2,1,0,4,24
24780,"Greenville, NC",3,0,0,0,1,4
24860,"Greenville-Anderson-Mauldin, SC",16,3,4,0,3,26
25060,"Gulfport-Biloxi-Pascagoula, MS",2,2,1,0,8,13
25180,"Hagerstown-Martinsburg, MD-WV",38,6,3,0,3,50
25260,"Hanford-Corcoran, CA",0,0,0,0,0,0
25420,"Harrisburg-Carlisle, PA",10,24,1,0,2,37
25500,"Harrisonburg, VA",12,1,0,1,1,15
25540,"Hartford-West Hartford-East Hartford, CT",39,19,3,2,12,75
25620,"Hattiesburg, MS",0,1,0,0,0,1
25860,"Hickory-Lenoir-Morganton, NC",9,3,2,0,6,20
25980,"Hinesville, GA",1,1,0,0,0,2
26300,"Hot Springs, AR",0,4,3,1,13,21
26380,"Houma-Thibodaux, LA",2,0,0,0,0,2
26420,"Houston-The Woodlands-Sugar Land, TX",3,30,1,2,2,38
26580,"Huntington-Ashland, WV-KY-OH",7,13,2,1,7,30
26620,"Huntsville, AL",6,5,2,0,2,15
26820,"Idaho Falls, ID",3,2,0,0,1,6
26900,"Indianapolis-Carmel-Anderson, IN",11,15,4,0,11,41
26980,"Iowa City, IA",3,2,1,0,2,8
27060,"Ithaca, NY",1,1,0,0,0,2
27100,"Jackson, MI",2,3,1,0,0,6
27140,"Jackson, MS",10,9,4,1,5,29
27180,"Jackson, TN",1,0,0,0,0,1
27260,"Jacksonville, FL",5,5,7,1,3,21
27340,"Jacksonville, NC",0,0,0,0,2,2
27500,"Janesville-Beloit, WI",0,3,2,1,7,13
27620,"Jefferson City, MO",3,0,1,0,6,10
27740,"Johnson City, TN",1,0,1,0,1,3
27780,"Johnstown, PA",0,7,0,0,2,9
27860,"Jonesboro, AR",1,10,1,0,2,14
27900,"Joplin, MO",1,0,0,0,4,5
28020,"Kalamazoo-Portage, MI",2,2,0,0,5,9
28100,"Kankakee, IL",0,0,0,0,1,1
28140,"Kansas City, MO-KS",21,11,14,1,28,75
28420,"Kennewick-Richland, WA",0,1,0,0,0,1
28660,"Killeen-Temple, TX",1,4,0,0,0,5
28700,"Kingsport-Bristol-Bristol, TN-VA",9,1,1,1,2,14
28740,"Kingston, NY",42,15,2,0,4,63
28940,"Knoxville, TN",5,8,12,0,11,36
29020,"Kokomo, IN",1,0,0,0,0,1
29100,"La Crosse-Onalaska, WI-MN",1,9,0,0,0,10
29180,"Lafayette, LA",2,2,1,0,3,8
29200,"Lafayette-West Lafayette, IN",2,5,1,0,2,10
29340,"Lake Charles, LA",0,2,0,0,0,2
29460,"Lakeland-Winter Haven, FL",0,0,1,0,1,2
29540,"Lancaster, PA",12,53,4,0,10,79
29620,"Lansing-East Lansing, MI",1,5,0,0,2,8
29700,"Laredo, TX",0,0,0,0,0,0
29740,"Las Cruces, NM",0,2,2,1,1,6
29820,"Las Vegas-Henderson-Paradise, NV",4,1,2,1,2,10
29940,"Lawrence, KS",0,1,3,0,1,5
30020,"Lawton, OK",1,1,3,0,0,5
30140,"Lebanon, PA",2,2,0,0,0,4
30300,"Lewiston, ID-WA",0,4,0,0,1,5
30340,"Lewiston-Auburn, ME",0,1,0,0,2,3
30460,"Lexington-Fayette, KY",79,2,5,9,8,103
30620,"Lima, OH",1,1,0,0,0,2
30700,"Lincoln, NE",4,2,0,0,1,7
30780,"Little Rock-North Little Rock-Conway, AR",4,20,8,9,12,53
30860,"Logan, UT-ID",2,2,1,0,0,5
30980,"Longview, TX",1,0,0,0,0,1
31020,"Longview, WA",1,3,0,0,0,4
31080,"Los Angeles-Long Beach-Anaheim, CA",15,17,4,3,52,91
31140,"Louisville/Jefferson County, KY-IN",45,6,3,7,19,80
31180,"Lubbock, TX",0,0,0,0,1,1
31340,"Lynchburg, VA",35,1,1,0,6,43
31420,"Macon-Bibb County, GA",9,2,1,0,2,14
31460,"Madera, CA",0,0,0,0,0,0
31540,"Madison, WI",7,5,6,0,10,28
31700,"Manchester-Nashua, NH",6,4,0,0,6,16
31900,"Mansfield, OH",1,2,0,0,0,3
32580,"McAllen-Edinburg-Mission, TX",6,0,0,0,0,6
32780,"Medford, OR",3,6,5,0,2,16
32820,"Memphis, TN-MS-AR",12,2,5,1,10,30
32900,"Merced, CA",1,0,0,0,0,1
33100,"Miami-Fort Lauderdale-West Palm Beach, FL",6,12,5,2,6,31
33140,"Michigan City-La Porte, IN",0,0,0,0,0,0
33260,"Midland, TX",0,0,0,0,0,0
33340,"Milwaukee-Waukesha-West Allis, WI",12,8,2,0,17,39
33460,"Minneapolis-St. Paul-Bloomington, MN-WI",8,41,8,0,8,65
33540,"Missoula, MT",0,2,1,0,1,4
33660,"Mobile, AL",5,2,1,1,2,11
33700,"Modesto, CA",0,1,0,0,0,1
33740,"Monroe, LA",1,0,0,0,0,1
33780,"Monroe, MI",0,1,0,1,1,3
33860,"Montgomery, AL",3,1,0,0,2,6
34060,"Morgantown, WV",0,2,2,0,3,7
34100,"Morristown, TN",1,0,0,0,1,2
34580,"Mount Vernon-Anacortes, WA",0,5,1,0,1,7
34620,"Muncie, IN",2,1,0,0,2,5
34740,"Muskegon, MI",0,1,0,0,0,1
34820,"Myrtle Beach-Conway-North Myrtle Beach, SC-NC",5,3,1,0,1,10
34900,"Napa, CA",1,9,0,0,2,12
34940,"Naples-Immokalee-Marco Island, FL",1,1,1,0,0,3
34980,"Nashville-Davidson--Murfreesboro--Franklin, TN",65,8,16,0,21,110
35300,"New Haven-Milford, CT",11,9,2,0,4,26
35380,"New Orleans-Metairie, LA",9,12,5,2,4,32
35620,"New York-Newark-Jersey City, NY-NJ-PA",234,172,45,19,111,581
35660,"Niles-Benton Harbor, MI",0,3,0,0,3,6
35840,"North Port-Sarasota-Bradenton, FL",5,1,3,0,7,16
35980,"Norwich-New London, CT",22,14,3,0,6,45
36100,"Ocala, FL",1,0,0,0,1,2
36140,"Ocean City, NJ",0,3,0,0,0,3
36220,"Odessa, TX",0,0,0,0,0,0
36260,"Ogden-Clearfield, UT",3,4,0,0,3,10
36420,"Oklahoma City, OK",3,10,5,1,8,27
36500,"Olympia-Tumwater, WA",2,4,5,0,0,11
36540,"Omaha-Council Bluffs, NE-IA",8,10,4,1,6,29
36740,"Orlando-Kissimmee-Sanford, FL",2,0,2,1,4,9
36780,"Oshkosh-Neenah, WI",2,4,0,0,0,6
36980,"Owensboro, KY",3,0,0,2,1,6
37100,"Oxnard-Thousand Oaks-Ventura, CA",0,1,0,0,2,3
37340,"Palm Bay-Melbourne-Titusville, FL",1,1,0,2,0,4
37460,"Panama City, FL",1,0,0,0,0,1
37620,"Parkersburg-Vienna, WV",1,1,0,1,0,3
37860,"Pensacola-Ferry Pass-Brent, FL",0,1,3,0,0,4
37900,"Peoria, IL",2,4,0,2,1,9
37980,"Philadelphia-Camden-Wilmington, PA-NJ-DE-MD",184,93,14,0,37,328
38060,"Phoenix-Mesa-Scottsdale, AZ",9,30,5,1,11,56
38220,"Pine Bluff, AR",3,13,5,5,2,28
38300,"Pittsburgh, PA",22,64,8,0,10,104
38340,"Pittsfield, MA",24,4,3,0,5,36
38540,"Pocatello, ID",0,0,1,0,1,2
38860,"Portland-South Portland, ME",17,13,3,2,22,57
38900,"Portland-Vancouver-Hillsboro, OR-WA",11,16,10,2,3,42
38940,"Port St. Lucie, FL",1,2,2,0,1,6
39140,"Prescott, AZ",3,12,1,0,2,18
39300,"Providence-Warwick, RI-MA",107,33,14,8,26,188
39340,"Provo-Orem, UT",1,6,14,0,3,24
39380,"Pueblo, CO",1,5,1,1,0,8
39460,"Punta Gorda, FL",0,0,0,0,0,0
39540,"Racine, WI",3,0,0,0,0,3
39580,"Raleigh, NC",26,1,2,0,9,38
39660,"Rapid City, SD",1,7,2,3,7,20
39740,"Reading, PA",32,14,1,0,3,50
39820,"Redding, CA",0,0,1,0,3,4
39900,"Reno, NV",1,3,0,1,1,6
40060,"Richmond, VA",136,7,6,8,18,175
40140,"Riverside-San Bernardino-Ontario, CA",4,4,1,1,5,15
40220,"Roanoke, VA",19,7,1,1,6,34
40340,"Rochester, MN",3,12,1,0,0,16
40380,"Rochester, NY",66,10,8,0,19,103
40420,"Rockford, IL",1,1,1,0,0,3
40580,"Rocky Mount, NC",11,1,1,0,0,13
40660,"Rome, GA",9,1,0,0,1,11
40900,"Sacramento--Roseville--Arden-Arcade, CA",9,6,5,0,11,31
40980,"Saginaw, MI",3,6,0,0,0,9
41060,"St. Cloud, MN",1,0,0,0,1,2
41100,"St. George, UT",0,25,2,1,3,31
41140,"St. Joseph, MO-KS",0,1,0,1,5,7
41180,"St. Louis, MO-IL",19,14,3,0,45,81
41420,"Salem, OR",2,3,1,0,2,8
41500,"Salinas, CA",1,1,3,0,2,7
41540,"Salisbury, MD-DE",41,11,4,2,7,65
41620,"Salt Lake City, UT",5,2,3,2,4,16
41660,"San Angelo, TX",0,1,0,0,0,1
41700,"San Antonio-New Braunfels, TX",14,14,2,2,6,38
41740,"San Diego-Carlsbad, CA",10,8,2,0,2,22
41860,"San Francisco-Oakland-Hayward, CA",9,20,9,2,23,63
41940,"San Jose-Sunnyvale-Santa Clara, CA",2,3,0,0,7,12
42020,"San Luis Obispo-Paso Robles-Arroyo Grande, CA",1,0,1,0,1,3
42100,"Santa Cruz-Watsonville, CA",1,2,1,0,4,8
42140,"Santa Fe, NM",2,6,1,1,3,13
42200,"Santa Maria-Santa Barbara, CA",1,1,0,0,3,5
42220,"Santa Rosa, CA",5,3,1,0,3,12
42340,"Savannah, GA",2,0,0,0,6,8
42540,"Scranton--Wilkes-Barre--Hazleton, PA",3,6,1,1,0,11
42660,"Seattle-Tacoma-Bellevue, WA",25,61,4,2,8,100
42680,"Sebastian-Vero Beach, FL",1,1,0,0,2,4
43100,"Sheboygan, WI",3,0,1,0,1,5
43300,"Sherman-Denison, TX",0,0,0,0,0,0
43340,"Shreveport-Bossier City, LA",1,2,1,2,4,10
43580,"Sioux City, IA-NE-SD",2,5,0,1,2,10
43620,"Sioux Falls, SD",4,31,2,3,1,41
43780,"South Bend-Mishawaka, IN-MI",5,3,0,0,3,11
43900,"Spartanburg, SC",15,1,1,1,2,20
44060,"Spokane-Spokane Valley, WA",1,11,2,1,1,16
44100,"Springfield, IL",3,7,0,0,1,11
44140,"Springfield, MA",14,1,6,0,14,35
44180,"Springfield, MO",2,2,1,0,5,10
44220,"Springfield, OH",3,1,0,0,1,5
44300,"State College, PA",6,0,0,0,1,7
44700,"Stockton-Lodi, CA",1,2,0,0,0,3
44940,"Sumter, SC",7,0,1,0,0,8
45060,"Syracuse, NY",19,6,4,0,13,42
45220,"Tallahassee, FL",6,1,2,0,4,13
45300,"Tampa-St. Petersburg-Clearwater, FL",3,8,1,0,2,14
45460,"Terre Haute, IN",6,8,1,0,0,15
45500,"Texarkana, TX-AR",0,4,2,0,3,9
45780,"Toledo, OH",2,2,2,0,7,13
45820,"Topeka, KS",3,9,4,0,3,19
45940,"Trenton, NJ",10,2,0,2,3,17
46060,"Tucson, AZ",11,5,17,1,5,39
46140,"Tulsa, OK",2,7,9,0,3,21
46220,"Tuscaloosa, AL",5,1,0,0,5,11
46340,"Tyler, TX",0,1,0,0,0,1
46520,"Urban Honolulu, HI",1,15,7,0,0,23
46540,"Utica-Rome, NY",8,6,3,0,3,20
46660,"Valdosta, GA",3,0,0,0,2,5
46700,"Vallejo-Fairfield, CA",1,3,1,0,1,6
47020,"Victoria, TX",1,1,1,0,0,3
47220,"Vineland-Bridgeton, NJ",0,3,0,0,0,3
47260,"Virginia Beach-Norfolk-Newport News, VA-NC",45,11,2,2,7,67
47300,"Visalia-Porterville, CA",0,2,0,2,4,8
47380,"Waco, TX",0,2,0,0,0,2
47580,"Warner Robins, GA",3,0,0,0,0,3
47900,"Washington-Arlington-Alexandria, DC-VA-MD-WV",255,39,13,55,27,389
47940,"Waterloo-Cedar Falls, IA",0,2,0,0,1,3
48140,"Wausau, WI",0,0,0,0,0,0
48260,"Weirton-Steubenville, WV-OH",1,3,0,1,0,5
48300,"Wenatchee, WA",0,10,2,0,2,14
48540,"Wheeling, WV-OH",1,4,0,1,5,11
48620,"Wichita, KS",4,7,0,1,7,19
48660,"Wichita Falls, TX",0,2,0,0,0,2
48700,"Williamsport, PA",2,8,0,0,0,10
48900,"Wilmington, NC",4,2,2,0,1,9
49020,"Winchester, VA-WV",14,1,2,1,3,21
49180,"Winston-Salem, NC",25,1,12,0,2,40
49340,"Worcester, MA-CT",40,12,8,0,20,80
49420,"Yakima, WA",2,5,0,0,0,7
49620,"York-Hanover, PA",4,17,0,0,2,23
49660,"Youngstown-Warren-Boardman, OH-PA",4,6,0,0,6,16
49700,"Yuba City, CA",0,1,0,0,1,2
49740,"Yuma, AZ",0,6,0,2,0,8
