cbsa_fips,cbsa,lfpr,pop,lf,emp,unemp
10180,"Abilene, TX",0.49813698596052525,160761,80081,76705,3376
10420,"Akron, OH",0.5416769869807458,702498,380527,358106,22421
10500,"Albany, GA",0.4739046186402866,156886,74349,70122,4227
10540,"Albany, OR",0.48038508489623793,108132,51945,48046,3899
10580,"Albany-Schenectady-Troy, NY",0.5316064516431002,854604,454313,436271,18042
10740,"Albuquerque, NM",0.4869810549304491,809551,394236,375221,19015
10780,"Alexandria, LA",0.4581018049077266,147930,67767,63582,4185
10900,"Allentown-Bethlehem-Easton, PA-NJ",0.5170627797567211,787738,407310,387428,19882
11020,"Altoona, PA",0.5112128146453089,126730,64786,61435,3351
11100,"Amarillo, TX",0.5307762709044014,240380,127588,122520,5068
11180,"Ames, IA",0.5661165001689108,82884,46922,45500,1422
11260,"Anchorage, AK",0.5293656651553278,350903,185756,174768,10988
11460,"Ann Arbor, MI",0.5549594721740096,342234,189926,181459,8467
11500,"Anniston-Oxford-Jacksonville, AL",0.47131738253098876,114477,53955,51524,2431
11540,"Appleton, WI",0.5555123306703716,215925,119949,114645,5304
11700,"Asheville, NC",0.5001992896207947,396408,198283,189614,8669
12020,"Athens-Clarke County, GA",0.5542704526914524,178974,99200,94920,4280
12060,"Atlanta-Sandy Springs-Roswell, GA",0.5417464739135629,4770870,2584602,2445674,138928
12100,"Atlantic City-Hammonton, NJ",0.5042466300696921,270332,136314,129021,7293
12220,"Auburn-Opelika, AL",0.5036746925863969,126133,63530,61161,2369
12260,"Augusta-Richmond County, GA-SC",0.4825859128843917,531294,256395,240687,15708
12420,"Austin-Round Rock, TX",0.5492879249297145,1453358,798312,761991,36321
12540,"Bakersfield, CA",0.4295212730996443,760726,326748,299406,27342
12580,"Baltimore-Columbia-Towson, MD",0.5167343549031835,2644231,1366365,1306160,60205
12620,"Bangor, ME",0.5161828940865314,149726,77286,73351,3935
12700,"Barnstable Town, MA",0.5502060857226514,221995,122143,116121,6022
12940,"Baton Rouge, LA",0.49411399107796355,733689,362526,337278,25248
12980,"Battle Creek, MI",0.5162005383386351,138946,71724,66925,4799
13020,"Bay City, MI",0.5089268538450968,109165,55557,51608,3949
13140,"Beaumont-Port Arthur, TX",0.4619914238614873,395516,182725,168636,14089
13220,"Beckley, WV",0.4006823472746247,124570,49913,47361,2552
13380,"Bellingham, WA",0.5528390401725533,185450,102524,97125,5399
13460,"Bend-Redmond, OR",0.5302240212852234,140567,74532,70250,4282
13740,"Billings, MT",0.5688216050296854,148558,84503,81494,3009
13780,"Binghamton, NY",0.48632620354796735,252088,122597,116654,5943
13820,"Birmingham-Hoover, AL",0.4884030274744596,1086318,530561,508760,21801
13900,"Bismarck, ND",0.5781182156274188,105942,61247,59332,1915
13980,"Blacksburg-Christiansburg-Radford, VA",0.4900228083513656,170990,83789,80395,3394
14010,"Bloomington, IL",0.5397621670479903,177015,95546,91543,4003
14020,"Bloomington, IN",0.5226388444728707,150096,78446,74477,3969
14100,"Bloomsburg-Berwick, PA",0.5136051984041664,83718,42998,40612,2386
14260,"Boise City, ID",0.5147482540495082,546980,281557,271210,10347
14460,"Boston-Cambridge-Newton, MA-NH",0.5363556649251728,4418046,2369644,2262546,107098
14500,"Boulder, CO",0.5996124764042378,280241,168036,160654,7382
14540,"Bowling Green, KY",0.5138433914938527,145918,74979,70908,4071
14740,"Bremerton-Silverdale, WA",0.5045703610418422,239806,120999,114535,6464
14860,"Bridgeport-Stamford-Norwalk, CT",0.5033158692724249,897653,451803,431973,19830
15180,"Brownsville-Harlingen, TX",0.3754877098457806,373429,140218,129543,10675
15260,"Brunswick, GA",0.5092581649135248,101532,51706,49267,2439
15380,"Buffalo-Cheektowaga-Niagara Falls, NY",0.5084344524418773,1148563,583969,553310,30659
15500,"Burlington, NC",0.49321302696843755,139311,68710,64582,4128
15540,"Burlington-South Burlington, VT",0.5682428606687089,206637,117420,113534,3886
15680,"California-Lexington Park, MD",0.5073861114265363,96871,49151,47414,1737
15940,"Canton-Massillon, OH",0.5047782648185444,405168,204520,191042,13478
15980,"Cape Coral-Fort Myers, FL",0.4914193672763045,555029,272752,263972,8780
16020,"Cape Girardeau, MO-IL",0.5066703873439731,93173,47208,44855,2353
16060,"Carbondale-Marion, IL",0.5234055262711796,123881,64840,61627,3213
16180,"Carson City, NV",0.4858883212461148,55982,27201,25967,1234
16220,"Casper, WY",0.559537770658734,69922,39124,37778,1346
16300,"Cedar Rapids, IA",0.5585222332315531,247265,138103,132080,6023
16540,"Chambersburg-Waynesboro, PA",0.5538016368308536,138927,76938,74296,2642
16580,"Champaign-Urbana, IL",0.530736224028907,221400,117505,112646,4859
16620,"Charleston, WV",0.4516964211647696,229041,103457,98348,5109
16700,"Charleston-North Charleston, SC",0.49418949613329477,598313,295680,279790,15890
16740,"Charlotte-Concord-Gastonia, NC-SC",0.5172141199730323,1934168,1000379,946471,53908
16820,"Charlottesville, VA",0.5067398463227223,204975,103869,100541,3328
16860,"Chattanooga, TN-GA",0.5028765083152509,499564,251219,239142,12077
16940,"Cheyenne, WY",0.48242196612700045,85732,41359,39658,1701
16980,"Chicago-Naperville-Elgin, IL-IN-WI",0.5065125089717863,9276302,4698563,4422922,275641
17020,"Chico, CA",0.4577792057815527,214752,98309,91677,6632
17140,"Cincinnati, OH-KY-IN",0.5299163600387176,2054879,1088914,1029587,59327
17300,"Clarksville, TN-KY",0.4127751616989223,237633,98089,92604,5485
17420,"Cleveland, TN",0.4886390640709259,109410,53462,50605,2857
17460,"Cleveland-Elyria, OH",0.5107186204094428,2111699,1078484,1023398,55086
17660,"Coeur d'Alene, ID",0.5332772362112216,125972,67178,64151,3027
17780,"College Station-Bryan, TX",0.5054889434889435,203500,102867,98487,4380
17820,"Colorado Springs, CO",0.5136361007046878,587778,301904,286044,15860
17860,"Columbia, MO",0.5761765219845953,148786,85727,82672,3055
17900,"Columbia, SC",0.5082098518221866,699160,355320,335004,20316
17980,"Columbus, GA-AL",0.44542844970281953,286358,127552,119930,7622
18020,"Columbus, IN",0.5075753461851751,73660,37388,35576,1812
18140,"Columbus, OH",0.5339121870823158,1791126,956304,903747,52557
18580,"Corpus Christi, TX",0.4733586671406747,416308,197063,185980,11083
18700,"Corvallis, OR",0.5179200177902968,80943,41922,39870,2052
18880,"Crestview-Fort Walton Beach-Destin, FL",0.5333944490376419,233437,124514,121022,3492
19060,"Cumberland, MD-WV",0.48138813110346734,101172,48703,45836,2867
19100,"Dallas-Fort Worth-Arlington, TX",0.5236029576859378,5776543,3024615,2866914,157701
19140,"Dalton, GA",0.4967023938454644,133885,66501,63337,3164
19180,"Danville, IL",0.45718499178029204,82728,37822,35444,2378
19300,"Daphne-Fairhope-Foley, AL",0.47713238491644405,160970,76804,73743,3061
19340,"Davenport-Moline-Rock Island, IA-IL",0.5424832920327401,372876,202279,193090,9189
19380,"Dayton, OH",0.5025846022322017,804766,404463,379186,25277
19460,"Decatur, AL",0.48301538420070217,148399,71679,68274,3405
19500,"Decatur, IL",0.47564433801751843,111083,52836,49634,3202
19660,"Deltona-Daytona Beach-Ormond Beach, FL",0.4876026309015542,563305,274669,264295,10374
19740,"Denver-Aurora-Lakewood, CO",0.5634146665586396,2332749,1314305,1246648,67657
19780,"Des Moines-West Des Moines, IA",0.5680377623289325,521578,296276,284639,11637
19820,"Detroit-Warren-Dearborn, MI",0.4985342068061551,4431048,2209029,2055031,153998
20020,"Dothan, AL",0.4771484818102647,136643,65199,62654,2545
20100,"Dover, DE",0.49808071376698826,144585,72015,69394,2621
20220,"Dubuque, IA",0.5595853209796297,90769,50793,48597,2196
20260,"Duluth, MN-WI",0.5098235519477233,276682,141059,133794,7265
20500,"Durham-Chapel Hill, NC",0.5334844758851985,458287,244489,233982,10507
20700,"East Stroudsburg, PA",0.48134160264124165,162045,77999,73678,4321
20740,"Eau Claire, WI",0.5581329250883347,154809,86404,82461,3943
20940,"El Centro, CA",0.3881291116050553,156113,60592,50920,9672
21060,"Elizabethtown-Fort Knox, KY",0.46568980645897684,140177,65279,61297,3982
21140,"Elkhart-Goshen, IN",0.5301390955150279,192242,101915,97189,4726
21300,"Elmira, NY",0.4568422237227099,88860,40595,38438,2157
21340,"El Paso, TX",0.3982687888493816,731511,291338,270806,20532
21500,"Erie, PA",0.507212917236329,277211,140605,133043,7562
21660,"Eugene, OR",0.5169266684731308,335831,173600,162936,10664
21780,"Evansville, IN-KY",0.5235844709785284,303844,159088,150929,8159
21820,"Fairbanks, AK",0.500348331877343,90431,45247,42606,2641
22020,"Fargo, ND-MN",0.5973650708124013,189303,113083,109814,3269
22140,"Farmington, NM",0.43635475005808877,124809,54461,51561,2900
22180,"Fayetteville, NC",0.42374953783628777,343493,145555,137622,7933
22220,"Fayetteville-Springdale-Rogers, AR-MO",0.5412745994357664,407987,220833,213392,7441
22380,"Flagstaff, AZ",0.534406612871482,127025,67883,64549,3334
22420,"Flint, MI",0.48063763818959204,442508,212686,195902,16784
22500,"Florence, SC",0.46386198516822563,199167,92386,84237,8149
22520,"Florence-Muscle Shoals, AL",0.4663540151826158,143717,67023,63515,3508
22540,"Fond du Lac, WI",0.5626353263441998,99297,55868,53301,2567
22660,"Fort Collins, CO",0.6031782957007226,275116,165944,158693,7251
22900,"Fort Smith, AR-OK",0.47420774779909114,266708,126475,120658,5817
23060,"Fort Wayne, IN",0.5243676222596965,403240,211446,200384,11062
23420,"Fresno, CA",0.4666785104358889,872470,407163,370589,36574
23460,"Gadsden, AL",0.4532343419853839,103174,46762,44542,2220
23540,"Gainesville, FL",0.5250864531950616,249557,131039,127175,3864
23580,"Gainesville, GA",0.5143590157722436,160979,82801,79099,3702
23900,"Gettysburg, PA",0.5526539967141959,98606,54495,52517,1978
24020,"Glens Falls, NY",0.529590989551514,127674,67615,64560,3055
24140,"Goldsboro, NC",0.43701766530779684,117009,51135,48460,2675
24220,"Grand Forks, ND-MN",0.5623817462184358,97777,54988,53021,1967
24260,"Grand Island, NE",0.5572945994369081,78140,43547,41958,1589
24300,"Grand Junction, CO",0.5438883512297034,130194,70811,67350,3461
24340,"Grand Rapids-Wyoming, MI",0.5338807659936562,970713,518245,488145,30100
24420,"Grants Pass, OR",0.4252417555169849,80660,34300,31812,2488
24500,"Great Falls, MT",0.4866256043777564,80041,38950,37279,1671
24540,"Greeley, CO",0.4984184243468429,222879,111087,105019,6068
24580,"Green Bay, WI",0.5649932614555256,296800,167690,159911,7779
24660,"Greensboro-High Point, NC",0.533137886217286,677080,360977,342202,18775
24780,"Greenville, NC",0.4967788601288456,147929,73488,69235,4253
24860,"Greenville-Anderson-Mauldin, SC",0.5035240247009363,763048,384213,360541,23672
25060,"Gulfport-Biloxi-Pascagoula, MS",0.48849860118122473,360304,176008,157513,18495
25180,"Hagerstown-Martinsburg, MD-WV",0.4755121734600637,234198,111364,106663,4701
25220,"Hammond, LA",0.4693109949199922,107677,50534,45709,4825
25260,"Hanford-Corcoran, CA",0.37093429419829554,145147,53840,48757,5083
25420,"Harrisburg-Carlisle, PA",0.5284770101279064,525775,277860,266649,11211
25500,"Harrisonburg, VA",0.524836623728581,116602,61197,59178,2019
25540,"Hartford-West Hartford-East Hartford, CT",0.5118092074526339,1187929,607993,577602,30391
25620,"Hattiesburg, MS",0.4889500193723363,129050,63099,59276,3823
25860,"Hickory-Lenoir-Morganton, NC",0.4975618295737225,354159,176216,164619,11597
25940,"Hilton Head Island-Bluffton-Beaufort, SC",0.43883729330304944,163343,71681,68165,3516
25980,"Hinesville, GA",0.3751947116957916,76395,28663,27079,1584
26140,"Homosassa Springs, FL",0.38361324752786063,133791,51324,49126,2198
26300,"Hot Springs, AR",0.4553509381514941,92096,41936,39562,2374
26380,"Houma-Thibodaux, LA",0.4827752035065748,199625,96374,90333,6041
26420,"Houston-The Woodlands-Sugar Land, TX",0.49539821331610256,5234054,2592941,2447949,144992
26580,"Huntington-Ashland, WV-KY-OH",0.455419715694294,361864,164800,155947,8853
26620,"Huntsville, AL",0.5201232908682671,372777,193890,186636,7254
26820,"Idaho Falls, ID",0.5263579099545642,116208,61167,59280,1887
26900,"Indianapolis-Carmel-Anderson, IN",0.5308594276573796,1772959,941192,893669,47523
26980,"Iowa City, IA",0.6075961877867985,141650,86066,83289,2777
27060,"Ithaca, NY",0.5491134733941448,99433,54600,52653,1947
27100,"Jackson, MI",0.4802725594460493,163047,78307,72944,5363
27140,"Jackson, MS",0.4995287309108513,545336,272411,256376,16035
27180,"Jackson, TN",0.478017623938126,126192,60322,56783,3539
27260,"Jacksonville, FL",0.5088025350019855,1249072,635531,611676,23855
27340,"Jacksonville, NC",0.3561973219681308,157205,55996,53011,2985
27500,"Janesville-Beloit, WI",0.5306996000280682,156761,83193,78337,4856
27620,"Jefferson City, MO",0.5386638975424022,144450,77810,74374,3436
27740,"Johnson City, TN",0.5002431520969225,189182,94637,89637,5000
27780,"Johnstown, PA",0.4566899132505528,146975,67122,63007,4115
27860,"Jonesboro, AR",0.5025051079328418,112570,56567,53657,2910
27900,"Joplin, MO",0.49537193066923446,166160,82311,78276,4035
27980,"Kahului-Wailuku-Lahaina, HI",0.5227817745803357,143448,74992,72966,2026
28020,"Kalamazoo-Portage, MI",0.5415745563090911,320268,173449,163618,9831
28100,"Kankakee, IL",0.48807880130099984,107917,52672,49324,3348
28140,"Kansas City, MO-KS",0.5308197009785129,1909428,1013562,956538,57024
28420,"Kennewick-Richland, WA",0.5217403211524242,219086,114306,107034,7272
28660,"Killeen-Temple, TX",0.4177991961581169,357533,149377,141661,7716
28700,"Kingsport-Bristol-Bristol, TN-VA",0.4636634393211666,302519,140267,132853,7414
28740,"Kingston, NY",0.5032723445773358,182438,91816,87828,3988
28940,"Knoxville, TN",0.5033964908197994,790669,398020,379301,18719
29020,"Kokomo, IN",0.4642459292266123,84382,39174,36607,2567
29100,"La Crosse-Onalaska, WI-MN",0.5597495928181615,129549,72515,69556,2959
29180,"Lafayette, LA",0.4772581972002686,436399,208275,196309,11966
29200,"Lafayette-West Lafayette, IN",0.5025661754147099,188023,94494,89847,4647
29340,"Lake Charles, LA",0.49627269135597096,192364,95465,88378,7087
29420,"Lake Havasu City-Kingman, AZ",0.4718842207307189,188773,89079,85271,3808
29460,"Lakeland-Winter Haven, FL",0.4716308623187479,547373,258158,247679,10479
29540,"Lancaster, PA",0.5408593108857096,494722,267575,257802,9773
29620,"Lansing-East Lansing, MI",0.5361183205364533,462743,248085,233089,14996
29700,"Laredo, TX",0.38275749542920745,223703,85624,80484,5140
29740,"Las Cruces, NM",0.44973282099799683,189199,85089,80297,4792
29820,"Las Vegas-Henderson-Paradise, NV",0.5025960930245467,1729522,869251,833919,35332
29940,"Lawrence, KS",0.5978936611122151,105681,63186,60679,2507
30020,"Lawton, OK",0.3998600535089525,121475,48573,46409,2164
30140,"Lebanon, PA",0.5556154266741682,126197,70117,67598,2519
30300,"Lewiston, ID-WA",0.5064344936333272,58979,29869,28362,1507
30340,"Lewiston-Auburn, ME",0.5312709590878605,107352,57033,54212,2821
30460,"Lexington-Fayette, KY",0.5242756890624356,436898,229055,218479,10576
30620,"Lima, OH",0.4932201645127783,106861,52706,49415,3291
30700,"Lincoln, NE",0.5789210036816607,285469,165264,159464,5800
30780,"Little Rock-North Little Rock-Conway, AR",0.5153733754223285,648784,334366,318763,15603
30860,"Logan, UT-ID",0.5635103926096998,112580,63440,61392,2048
30980,"Longview, TX",0.5023047148161646,203062,101999,96916,5083
31020,"Longview, WA",0.44520179000580096,96536,42978,39717,3261
31080,"Los Angeles-Long Beach-Anaheim, CA",0.5003383510282696,12726428,6367520,6051809,315711
31140,"Louisville/Jefferson County, KY-IN",0.5033408351107059,1172611,590223,556285,33938
31180,"Lubbock, TX",0.5289413556740289,270478,143067,137152,5915
31340,"Lynchburg, VA",0.6957565192473015,167504,116542,111806,4736
31420,"Macon, GA",0.4826958904109589,228125,110115,103927,6188
31460,"Madera, CA",0.44102114558166383,140313,61881,57015,4866
31540,"Madison, WI",0.6132982919048716,573036,351442,339626,11816
31700,"Manchester-Nashua, NH",0.5706328002603556,396381,226188,217986,8202
31740,"Manhattan, KS",0.5321693687273591,84195,44806,43097,1709
31860,"Mankato-North Mankato, MN",0.5962178002656101,91111,54322,52538,1784
31900,"Mansfield, OH",0.49137985030221415,127724,62761,58534,4227
32580,"McAllen-Edinburg-Mission, TX",0.38604733163254723,674982,260575,239969,20606
32780,"Medford, OR",0.5070698147415781,194701,98727,92614,6113
32820,"Memphis, TN-MS-AR",0.47176612564024956,1271965,600070,563310,36760
32900,"Merced, CA",0.4070763623770377,242554,98738,88880,9858
33100,"Miami-Fort Lauderdale-West Palm Beach, FL",0.5008691316519156,5411148,2710277,2612500,97777
33140,"Michigan City-La Porte, IN",0.4844761322244639,109541,53070,49849,3221
33220,"Midland, MI",0.4993089479328011,83930,41907,39428,2479
33260,"Midland, TX",0.5389759221190425,126963,68430,65888,2542
33340,"Milwaukee-Waukesha-West Allis, WI",0.5142043009975755,1522391,782820,744046,38774
33460,"Minneapolis-St. Paul-Bloomington, MN-WI",0.5768654155019965,3199046,1845419,1774937,70482
33540,"Missoula, MT",0.5659836946958885,102298,57899,55617,2282
33660,"Mobile, AL",0.4552989994649005,396188,180384,171439,8945
33700,"Modesto, CA",0.4532358705651774,500020,226627,207585,19042
33740,"Monroe, LA",0.48122107976614165,172241,82886,77791,5095
33780,"Monroe, MI",0.5109467494454435,152374,77855,73029,4826
33860,"Montgomery, AL",0.46979721685500714,358659,168497,161084,7413
34060,"Morgantown, WV",0.4878311113334501,119937,58509,56201,2308
34100,"Morristown, TN",0.49123051354186975,107703,52907,49801,3106
34580,"Mount Vernon-Anacortes, WA",0.5084972398652006,110683,56282,52784,3498
34620,"Muncie, IN",0.47484979267157484,118170,56113,52262,3851
34740,"Muskegon, MI",0.5187203354684116,173608,90054,83745,6309
34820,"Myrtle Beach-Conway-North Myrtle Beach, SC-NC",0.516725676249823,317745,164187,155072,9115
34900,"Napa, CA",0.5470735766714475,130381,71328,68214,3114
34940,"Naples-Immokalee-Marco Island, FL",0.4720606793906041,307452,145136,140087,5049
34980,"Nashville-Davidson--Murfreesboro--Franklin, TN",0.5160595774526735,1511310,779926,744286,35640
35100,"New Bern, NC",0.43655921281635496,117787,51421,49009,2412
35300,"New Haven-Milford, CT",0.5075322075352766,847162,429962,407064,22898
35380,"New Orleans-Metairie, LA",0.007326057897053497,1231358,9021,8067,954
35620,"New York-Newark-Jersey City, NY-NJ-PA",0.49437582647630396,19227714,9505717,9041419,464298
35660,"Niles-Benton Harbor, MI",0.49883918995646964,158510,79071,73591,5480
35840,"North Port-Sarasota-Bradenton, FL",0.4652371149910264,674757,313922,303104,10818
35980,"Norwich-New London, CT",0.5344873620505518,269664,144132,137659,6473
36100,"Ocala, FL",0.4212111029852615,303558,127862,123011,4851
36140,"Ocean City, NJ",0.581248929675931,99269,57700,53895,3805
36220,"Odessa, TX",0.49677774410183606,125378,62285,59458,2827
36260,"Ogden-Clearfield, UT",0.507695919613091,532425,270310,258890,11420
36420,"Oklahoma City, OK",0.49416175553772124,1161308,573874,548926,24948
36500,"Olympia-Tumwater, WA",0.537174647502676,227023,121951,115486,6465
36540,"Omaha-Council Bluffs, NE-IA",0.5407001519079366,814309,440297,421454,18843
36740,"Orlando-Kissimmee-Sanford, FL",0.5193686042599579,1955794,1015778,979207,36571
36780,"Oshkosh-Neenah, WI",0.5647843618187561,161451,91185,87160,4025
36980,"Owensboro, KY",0.4946397653159174,111469,55137,51846,3291
37100,"Oxnard-Thousand Oaks-Ventura, CA",0.5237466270962998,794197,415958,396225,19733
37340,"Palm Bay-Melbourne-Titusville, FL",0.49147303206034265,529907,260435,250969,9466
37460,"Panama City, FL",0.49651926714344874,178698,88727,85584,3143
37620,"Parkersburg-Vienna, WV",0.4689331390642707,92655,43449,41026,2423
37860,"Pensacola-Ferry Pass-Brent, FL",0.46221024823025864,439471,203128,195439,7689
37900,"Peoria, IL",0.5167292277403372,369772,191072,182174,8898
37980,"Philadelphia-Camden-Wilmington, PA-NJ-DE-MD",0.5003114525146852,5829139,2916385,2778245,138140
38060,"Phoenix-Mesa-Scottsdale, AZ",0.5148753700960289,3774696,1943498,1863495,80003
38220,"Pine Bluff, AR",0.4480595090312461,103917,46561,43106,3455
38300,"Pittsburgh, PA",0.5040318250330703,2374483,1196815,1134199,62616
38340,"Pittsfield, MA",0.5481469188235027,132563,72664,69494,3170
38540,"Pocatello, ID",0.5237603172347873,77419,40549,38984,1565
38860,"Portland-South Portland, ME",0.560341533294009,510287,285935,274785,11150
38900,"Portland-Vancouver-Hillsboro, OR-WA",0.5290861378834968,2067325,1093793,1029285,64508
38940,"Port St. Lucie, FL",0.4626481919989997,383877,177600,169596,8004
39140,"Prescott, AZ",0.4679159161617816,195424,91442,87403,4039
39300,"Providence-Warwick, RI-MA",0.5290627655571967,1613353,853565,807810,45755
39340,"Provo-Orem, UT",0.4755392688735576,439623,209058,200841,8217
39380,"Pueblo, CO",0.4627131653595862,149825,69326,64606,4720
39460,"Punta Gorda, FL",0.4256546997977612,155262,66088,63430,2658
39540,"Racine, WI",0.5097463919979716,193251,98509,92687,5822
39580,"Raleigh, NC",0.5300209055545264,944725,500724,479811,20913
39660,"Rapid City, SD",0.5565326433752916,125998,70122,67559,2563
39740,"Reading, PA",0.5018828943280808,395933,198712,189015,9697
39820,"Redding, CA",0.46549554423027645,175615,81748,75826,5922
39900,"Reno, NV",0.5315121070443277,396546,210769,202449,8320
40060,"Richmond, VA",0.5223756336591271,1135074,592935,570318,22617
40140,"Riverside-San Bernardino-Ontario, CA",0.43967387644428413,3875709,1704048,1614040,90008
40220,"Roanoke, VA",0.5041649094988276,296405,149437,144169,5268
40340,"Rochester, MN",0.5747256425340285,197188,113329,109202,4127
40380,"Rochester, NY",0.5119476690414398,1070418,547998,522666,25332
40420,"Rockford, IL",0.4912400306040732,335903,165009,154466,10543
40580,"Rocky Mount, NC",0.46529548994402387,147027,68411,63712,4699
40660,"Rome, GA",0.5315163465207989,94332,50139,47541,2598
40900,"Sacramento--Roseville--Arden-Arcade, CA",0.4973260928323955,2034850,1011984,962619,49365
40980,"Saginaw, MI",0.47434994791867596,207368,98365,90520,7845
41060,"St. Cloud, MN",0.5736181941949091,179222,102805,98294,4511
41100,"St. George, UT",0.47852100840336137,119000,56944,54639,2305
41140,"St. Joseph, MO-KS",0.5251287616209388,123484,64845,61107,3738
41180,"St. Louis, MO-IL",0.5224662639782355,2730316,1426498,1347532,78966
41420,"Salem, OR",0.49825293577433255,368046,183380,171788,11592
41500,"Salinas, CA",0.5098620473467131,405139,206565,191535,15030
41540,"Salisbury, MD-DE",0.5238469904889732,345704,181096,173065,8031
41620,"Salt Lake City, UT",0.5441311404392808,997221,542619,520747,21872
41660,"San Angelo, TX",0.4953324514246578,106587,52796,50523,2273
41700,"San Antonio-New Braunfels, TX",0.47182607650153346,1896328,894737,849881,44856
41740,"San Diego-Carlsbad, CA",0.5070145913983068,2938375,1489799,1425706,64093
41860,"San Francisco-Oakland-Hayward, CA",0.518831724046596,4137858,2146852,2043848,103004
41940,"San Jose-Sunnyvale-Santa Clara, CA",0.4854797136810757,1729959,839860,794572,45288
42020,"San Luis Obispo-Paso Robles-Arroyo Grande, CA",0.5083966513929973,258615,131479,125879,5600
42100,"Santa Cruz-Watsonville, CA",0.5688348576043154,251377,142992,134029,8963
42140,"Santa Fe, NM",0.557401351645956,137610,76704,73560,3144
42200,"Santa Maria-Santa Barbara, CA",0.5224625623960066,408079,213206,203962,9244
42220,"Santa Rosa, CA",0.5438706437337156,465938,253410,242205,11205
42340,"Savannah, GA",0.5260517346627327,314528,165458,158113,7345
42540,"Scranton--Wilkes-Barre--Hazleton, PA",0.49765742330935664,556652,277022,261635,15387
42660,"Seattle-Tacoma-Bellevue, WA",0.5399937153425373,3198265,1727043,1643548,83495
42680,"Sebastian-Vero Beach, FL",0.4648821851432144,127955,59484,56638,2846
42700,"Sebring, FL",0.4181709791453134,95614,39983,38293,1690
43100,"Sheboygan, WI",0.5639820364513254,114454,64550,61993,2557
43300,"Sherman-Denison, TX",0.4877492089291581,115666,56416,53380,3036
43340,"Shreveport-Bossier City, LA",0.47115969286027404,424302,199914,187877,12037
43420,"Sierra Vista-Douglas, AZ",0.44340387642503937,125786,55774,53097,2677
43580,"Sioux City, IA-NE-SD",0.5377153603494298,164840,88637,84638,3999
43620,"Sioux Falls, SD",0.5835483168364753,206605,120564,116483,4081
43780,"South Bend-Mishawaka, IN-MI",0.5101143997402442,317221,161819,153248,8571
43900,"Spartanburg, SC",0.4914919549778362,293722,144362,133163,11199
44060,"Spokane-Spokane Valley, WA",0.5000182035889387,494408,247213,232037,15176
44100,"Springfield, IL",0.546875914687689,204988,112103,107050,5053
44140,"Springfield, MA",0.5060289037029828,616530,311982,295361,16621
44180,"Springfield, MO",0.5274211123328609,402883,212489,203276,9213
44220,"Springfield, OH",0.4989070999596794,141367,70529,65964,4565
44300,"State College, PA",0.4973650398851199,145543,72388,69492,2896
44420,"Staunton-Waynesboro, VA",0.5024762238681685,114085,57325,55462,1863
44700,"Stockton-Lodi, CA",0.43165064651399954,656985,283588,261289,22299
44940,"Sumter, SC",0.43783111178145206,106082,46446,42505,3941
45060,"Syracuse, NY",0.5038601815819646,655021,330039,313962,16077
45220,"Tallahassee, FL",0.5211484443308342,344257,179409,173655,5754
45300,"Tampa-St. Petersburg-Clearwater, FL",0.4746660481675077,2651580,1258615,1208734,49881
45460,"Terre Haute, IN",0.47257287527690844,170634,80637,75006,5631
45500,"Texarkana, TX-AR",0.47339034414047904,144534,68421,64886,3535
45540,"The Villages, FL",0.36896666233522474,69261,25555,24685,870
45780,"Toledo, OH",0.5118778766542535,616819,315736,294712,21024
45820,"Topeka, KS",0.5413438617401669,228208,123539,116774,6765
45940,"Trenton, NJ",0.5351187105506678,362015,193721,186136,7585
46060,"Tucson, AZ",0.479823926597689,920298,441581,421815,19766
46140,"Tulsa, OK",0.5015670643510134,882861,442814,423536,19278
46220,"Tuscaloosa, AL",0.4696558375873344,212545,99823,95834,3989
46340,"Tyler, TX",0.49832255097668293,191362,95360,90560,4800
46520,"Urban Honolulu, HI",0.4783991391675498,918181,439257,427016,12241
46540,"Utica-Rome, NY",0.47862171521967756,298574,142904,135947,6957
46660,"Valdosta, GA",0.512843027901053,126411,64829,62216,2613
46700,"Vallejo-Fairfield, CA",0.5107685071083662,408181,208486,197341,11145
47020,"Victoria, TX",0.5167662773291959,91523,47296,45147,2149
47220,"Vineland-Bridgeton, NJ",0.4544210706345134,152022,69082,64663,4419
47260,"Virginia Beach-Norfolk-Newport News, VA-NC",0.48045891694001197,1649013,792283,760770,31513
47300,"Visalia-Porterville, CA",0.44930999828418755,407970,183305,166019,17286
47380,"Waco, TX",0.4953734467406472,240784,119278,113199,6079
47460,"Walla Walla, WA",0.5057397221809292,60543,30619,28732,1887
47580,"Warner Robins, GA",0.48388292646758974,161847,78315,74297,4018
47900,"Washington-Arlington-Alexandria, DC-VA-MD-WV",0.550758242460478,5273577,2904466,2803967,100499
47940,"Waterloo-Cedar Falls, IA",0.5642165870390787,163260,92114,88247,3867
48060,"Watertown-Fort Drum, NY",0.415073224891176,113486,47105,44219,2886
48140,"Wausau, WI",0.5766528637230727,128958,74364,71307,3057
48260,"Weirton-Steubenville, WV-OH",0.4513980418000377,127464,57537,53188,4349
48300,"Wenatchee, WA",0.5747951513509854,103369,59416,55838,3578
48540,"Wheeling, WV-OH",0.45844430466146496,149438,68509,64464,4045
48620,"Wichita, KS",0.5226055310513693,596270,311614,294782,16832
48660,"Wichita Falls, TX",0.49124722134010795,151152,74253,70877,3376
48700,"Williamsport, PA",0.504526503871352,117530,59297,56082,3215
48900,"Wilmington, NC",0.5188677202388944,230897,119805,114728,5077
49020,"Winchester, VA-WV",0.5212351608441453,117847,61426,59522,1904
49180,"Winston-Salem, NC",0.5131543368087524,602805,309332,293831,15501
49340,"Worcester, MA-CT",0.5122739298986175,896901,459459,435280,24179
49420,"Yakima, WA",0.5143282145513409,228570,117560,108427,9133
49620,"York-Hanover, PA",0.535160585333418,409066,218916,209684,9232
49660,"Youngstown-Warren-Boardman, OH-PA",0.4814145992448076,584222,281253,261923,19330
49700,"Yuba City, CA",0.4236273694122503,155049,65683,59513,6170
49740,"Yuma, AZ",0.42539258231925553,178816,76067,64004,12063
